#################                         
#+OOO#**O #*O#O+#                         
#******#OO*+****#                         
#*######## ######                         
#*O* O O O O O O#                         
##+# OOO OOO OOO#                         
#O# * O   OO+ O #                         
#*  O     OOO   #                         
#   *      OO   #                         
#OO*    +  O    #                         
#**     *       #                         
#               #                         
#               #                         
#               #                         
#               #                         
#      #+******p#                         
#################
